10 10
0 0
9 9
|L--LLLL__
|_|L_-L_-L
|L-LL-__L-
L-_|||||_|
|_L|-L-||_
|-_-|-|-LL
|-LL-_-|LL
|L-|--L__-
|---|_L_|-
L_____LLL_
