10 10
0 0
9 9
||-L--L|-_
L--|LL_|-_
|_L_-LLL--
L--_---||_
L-|L|-___-
LL--L-----
|-L|-___-|
|-_L-L|-__
L__-|L-LL-
LL__LLLLL_
