10 10
0 0
9 9
|_||L_|-|L
L-|-_-LLL_
||__-||LL|
|-_L---|__
LL|_-__|L-
L-|_-L-_--
LL-L-||_||
|_-||_L||_
L-L|--L___
L________L
