10 10
0 0
9 9
L|LL|_|---
L__|L-||-|
LL_|LL_L|-
L-_L|||-|-
|-L__L--|_
|-_-L|L_L-
L--L-|-__L
L_--LL_-|-
|_-|L_||||
L__LL__LL_
