10 10
0 0
9 9
|_L|LL|||-
|--|-LL_LL
||L|LL-|L_
LLL|-L|L-|
|--L-_---L
L_|___-L__
LL-_|_-_L-
|----__-|_
|-|--__L_L
LLLLL_LL__
