10 10
0 0
9 9
L_-LL|-|_L
L__-_L|-LL
|LLL-|-_L-
L-|-_LL_-|
|L-_|||||L
|_--|-L-_-
L_-_L_|__L
||LL-|__|-
L|_|L|-|-|
LL_L_L_L_L
