10 10
0 0
9 9
|--|_-L-L|
|L|__--|-L
||_-|-L_-_
|_|L-L-_LL
L--_L__|--
||_-L|-|-|
|L--||L|L-
L_LL--_-_-
L___-___--
LLLL____LL
