10 10
0 0
9 9
|||__|_--_
||_|||__|_
|L-_-L--_L
L|_L|L|||-
L|L_L-|_||
|L|_|L_LL_
|L---L__|-
L|_L-|L-_-
|-L-L_-|-|
LLLL__LL__
