10 5
0 0
9 4
L|||_--_LL
L_-L_L--LL
|-LL|_|--_
|||--L|-|_
L_L_L__L_L
