10 5
0 0
9 4
L_|_L_|||L
||_____-_-
|LLL--__L-
|||___--|_
L_LLLLLL_L
