10 5
0 0
9 4
|_L__-|-||
L_----_|_L
||__---|_L
||||-||---
LLL_LLLLL_
