10 5
0 0
9 4
|--__L--__
L__---|_|L
LL|_L_L_L_
|__-|__-_|
L__LL_L__L
