10 5
0 0
9 4
L_--_L_|_-
LL__--_|L_
||--L|L__|
L-||L|_|L|
L__LL__L__
