10 6
0 0
9 5
|||L_L-LL_
|-___L|-L-
LL-LL_L|L_
|-|__|--|-
|_|__|-L|_
L_L_____L_
