10 6
0 0
9 5
||__|--_LL
LL||L||-|_
LLL-|_|-_|
|L__-_|__-
|--L--_--L
L_L_L_LL__
