10 6
0 0
9 5
L__-||||L_
|L-||L-|||
L---|-|L|_
L|L----|_-
L|-L||-L_|
L__LL_LLL_
