10 6
0 0
9 5
L-L-L_-|||
|-LLL-L-|-
L||-_||_--
|_-|_LL---
L_L-_--L--
LLL__LLL__
