10 6
0 0
9 5
L-L|L-LL--
L|_|LL|-_|
|-|||_||L|
|_-|_--L||
|-|-L_-__|
L____L__L_
