10 6
0 0
9 5
L--_--|_LL
L__-|-||L|
|_||_|___L
|LL_L---|-
LL__|_|_|L
L_LLLL_L__
