10 6
0 0
9 5
|L|_|_-_-_
|-||-|L_-|
L|L_|L-_||
L||_-|_-|-
L_L|-LLL_|
LL_L_____L
