10 6
0 0
9 5
|-__-___L_
L_||||_--_
L|__|_-_LL
LL||-L_L|_
|L__L_--|_
LL____LLL_
