10 6
0 0
9 5
|_-__-|L--
LL|L___L|-
|LL|_-L|_-
L-_L-_|||L
|-|_|L-|L|
LLL_L_L___
