10 7
0 0
9 6
||-L-_-LL-
LL_-|--L-|
L|-|L_|-L|
L|_|||_LLL
||_||-_-LL
|_-L-||LL|
LLL____LL_
