10 7
0 0
9 6
|--L_|||-L
|L||_|__LL
L-L|||_-|_
|L_L-|_L|_
||L_L---L-
L|-_|-__L-
L_L___LLL_
