10 7
0 0
9 6
L|_|_-L|LL
|_L|-||-L_
||||-L-L_L
L-_-LL__|_
|-L__L|-L|
|L|--L-||L
LL_L___LL_
