10 7
0 0
9 6
LL-LLL-|_L
|-_-||L|-|
L|__L|||__
L_-|-_|-L-
|_--|_-_|L
||L|L_|||-
LL_LLLL___
