10 7
0 0
9 6
|--L_L|||L
|_--L|L_|-
L-_L___L__
L-L-_L--_-
|__-LLL_-_
||L_-_-|--
LLL_L_LL_L
