10 7
0 0
9 6
L_||_-_LLL
LL|_L_L|-L
L_LL---|-_
|L_--L||||
L|---|-|__
|-LL_-|-|_
LL__LLL___
