10 8
0 0
9 7
|||_|L-_-|
L|--|L|--|
L|LLLL__|-
LL_|L|-_-|
L|||-|LL|-
|___-__|-|
L_-|_-L|--
L_L_LLL_L_
