10 8
0 0
9 7
|_-_LL-_L|
L-L_|LL-_|
||_-|_L_||
L|-__-L|_L
|___L--L-_
L-L|L_L_L-
|_|||-L---
LLL___LLLL
