10 8
0 0
9 7
|L--_L__L-
LL-L||L_LL
L|L_-LL-L_
|_LL_|-|--
L-__L_|---
||--__|||L
L|-L|-|_|-
LL___L____
