10 8
0 0
9 7
LL_--____-
||-||-||_-
L-|-||_LL|
L|_L_|LL|-
||-_L|-|_L
||_|LLL|_|
L|L--||L|L
L__L_L_LLL
