10 8
0 0
9 7
||-L_L||_|
L-|L_-_|L-
|_L_LL-|||
|__-_L||LL
||L-|_L_|-
||_|--|L_-
|--L--|L_|
LL__LLL__L
