10 8
0 0
9 7
|L-_|-|||-
|----_|L|-
L|__|L__L-
LL__|_---_
|-_L-|---_
L-_||_-L_-
|-L-|-|_L-
LLL___L___
