10 9
0 0
9 8
L-||-_|LLL
L|-_||LL|L
|_L__L_|__
|_LL_L_LLL
|L|--|L-_|
|LL_-|---|
|_-L|_--|L
L--|_--|L|
LL_L_L_L__
