10 9
0 0
9 8
|-__-____-
|_|L_---__
|-L-L|--||
LL-LL_|_-_
L-L|-L-L|_
L||LL_|L_|
LL|L_LL_LL
L|-_-||-|-
L__LLL___L
