10 9
0 0
9 8
|L__L__|_|
|-LL___||_
L|__|LLL_-
LL||||||-L
|L_LL_|___
|-__|L|--_
L-||_-|L__
|LL_|-L__L
L__LLLLLL_
