10 9
0 0
9 8
L--|_-__LL
|_|-_L|L_|
||__L_L-_-
L__L-LL|__
|-_|_||LL_
||_---|-_-
||-L|_L_L_
L|-_|LL-L-
L_LLL_L_LL
