10 9
0 0
9 8
L||___LL|-
L|-LL__LL|
||_LLLL--_
||--L_|L||
L_L_||_---
|_||L|L|L-
|L---L-|L_
||L--_||L|
LL_____L__
