10 9
0 0
9 8
LL-|||-_L|
|-||_-_-||
||LLL-LL-_
L-_|L___|-
L|_--_L_-|
|-_-|_|-||
L__-L|||_|
L|LL-||-||
LL_L__L__L
