10 9
0 0
9 8
|-_-|--|-|
LL_-L-|__-
|-LL_L|___
LLLL|-L_-_
|_-L__L--L
L-_-|_-L__
|LL_L_||-L
L---L__-L_
LL_L_L_LL_
