8 10
0 0
7 9
L-_--LL|
L--L--|L
|-|L|_|_
|L-|__-L
|--__L|L
L|||-L-_
|LL_||-|
L-|-|-L_
L-_||_-|
LL_L_LLL
