8 10
0 0
7 9
|_|-___-
|-L__-|_
L-_-__L|
||L__L-|
L|-__L-L
L-|LL|__
L|_L-__L
L||__-LL
|L--L-|L
LLLLL_L_
