8 10
0 0
7 9
|__||L|_
L|__-L|L
L|-L_L|L
|||-L_-_
LL_-L|-L
L-|_---_
|_-L-LL|
LL|-|||-
LL|||_|-
LLL_L__L
