8 10
0 0
7 9
L|L-||_L
|_L_--|L
|-L|_L-_
|-L_|_|-
L-_-_|L_
||L___L_
L||||__-
||||-_-|
LL_|-L-_
LL_LL_L_
