8 10
0 0
7 9
LL||_-|L
|__L||-|
L--|-L-L
|||_-|-|
LL|L|-_|
|L_-|-__
|L-L|--|
|_L_||--
|L__|_LL
LLL___L_
