8 5
0 0
7 4
|-|-LLL-
|--LL_--
L_L--_L-
L____|__
LLL__L_L
