8 5
0 0
7 4
|--||L__
|_|__-_L
LL--__|-
|L-||_-L
L___LLL_
