8 5
0 0
7 4
|L||-__|
|-|L_|L|
L--|--_|
||-|-L_|
LLL_LLLL
