8 5
0 0
7 4
|L--|--_
|-L_--|-
L|L_-_LL
|L-|_-LL
LLLL___L
