8 6
0 0
7 5
L_|-L__|
||__|_-|
L_|L-|-|
L-__-_--
|L_|-_|-
L_LLL___
