8 6
0 0
7 5
L|LL_-_L
L_|_||-L
|L_-_|-|
L-L|L_|-
L-__-___
LL_L____
