8 6
0 0
7 5
|L---__-
||LL_|||
|-||____
LL||L_|_
||_|_L__
L____L_L
