8 6
0 0
7 5
|LL_L|-|
|_|_|-L_
|---__-|
L|L||-_-
|--L--|_
LLL_____
