8 6
0 0
7 5
L-|||__L
|-___-L|
LLLL_|-_
|--||-__
L_L||_-|
L_LLL_L_
