8 6
0 0
7 5
L-__L|_|
|-_L|_||
L_--|-|_
|||L_L-_
L-L-|_-|
L_LLL__L
