8 7
0 0
7 6
|_-LL--_
|-__L_-|
||L--_-|
|-|-L||-
|-_|-_-L
||__--L-
L__L___L
