8 7
0 0
7 6
L-|L_-|_
L_|||_|-
L-L|L-_L
L_LL-__-
||-LL-L_
|---_-LL
L__LL___
