8 7
0 0
7 6
|_|L_|L_
|__-|_-|
|-|_||L-
||_LL|L_
LLLL-||-
|---L||_
LLL___L_
