8 7
0 0
7 6
|||-|_-_
||L--L_L
L||_||L-
|||L-|_|
|_--_-L_
L-___|-|
L_L__L__
