8 7
0 0
7 6
L--L__L_
|L_||-_-
||_|-_--
|-----_|
|L_|-|||
||__|-L|
LL_LL_LL
