8 7
0 0
7 6
|-_-LL_L
|_|L-_||
|-L|||_-
L__L_||L
|L_-||L-
L_L_|L--
LL__L_LL
