8 8
0 0
7 7
L__-|-|-
LL-|_---
|L|_--_L
L-_|L|__
L_||||_-
L||-_LL_
LL---L|-
L_L__LLL
