8 8
0 0
7 7
|-LL-||L
|_-_|||_
L__||_||
|||_L-||
||-|L-L_
|LL--_|L
|_-L-LL_
LL___LL_
