8 8
0 0
7 7
|-_-_L_|
L_L|_L||
|-_||-_|
||-_|L-L
||L||-|-
L---|L_-
||L|LL_|
LL_LLLL_
