8 8
0 0
7 7
L_-_-|--
LL_||L-L
LL||-_|-
L_-|L|||
L_L|L_||
||||L|-L
L|__|-__
L__L___L
