8 8
0 0
7 7
||-L____
|_L__L|L
|L-_||L|
L-||__L_
L|L|L_||
|-||LL--
L-_-_L|_
LLL__LL_
