8 8
0 0
7 7
L_|__--|
L|-L--L_
||LL|L|L
L|||-_-L
|||L|L--
|_|-|_L|
L-_-__L-
L__L___L
