8 9
0 0
7 8
|LLL||||
L-LL|L-|
L|--L||-
||L|-|L-
L|___-L_
|-||-L-L
||_|___L
|_|_||_|
LL_L__LL
