8 9
0 0
7 8
||L-____
|_||LL--
|L|-|_-L
L-|-L_L|
|L|_-|--
|-_L|_|-
|-|_L_||
|---__-_
LL_L_LLL
