8 9
0 0
7 8
|-_|LLL-
L|LL|_|_
L|L--L--
L|-L_||_
|L||_|LL
|--_L_--
||L-__|L
L--|__--
L_L__LL_
