8 9
0 0
7 8
LL|-|-||
|-L||L|_
LL_|-L__
|L-|-LLL
|-LL-__|
L|__L-L-
|-__||_L
L-|_-||-
LL_L__LL
