8 9
0 0
7 8
L--|_L_|
|L_-|_|L
L_|L|__-
||L-|LL-
|--L-LL|
L|L--_-|
|L|_|_L|
L__L_-|_
LLLL_L__
