9 10
0 0
8 9
||__L|_L|
|L|_|-|_|
|-|-|LL_|
|_L--|LL|
|__-|__L-
|___--L||
|--_-_-L|
||-|_-|L_
|-|L|||_|
L_LL____L
