9 10
0 0
8 9
L|__|-L|L
|L_|-L|L_
|L||||L|L
|||L-|_|_
|__LL_-L-
L|L|LL|_|
L_|__|_-|
|--|_-_L|
||LL|_--L
LLL____LL
