9 10
0 0
8 9
L--|L__|-
|_|LL-__|
|_-|L-LLL
|L|_L||-_
LL|L_L-||
|_--LL_|L
|LL__L|-_
|-|L|L_-L
L--L||-L_
L__L____L
