9 10
0 0
8 9
|L------L
L|L|LL-__
L--|||-_L
L__--___|
|L__-LL_-
L|L-__-L|
|||--||L_
L|||__|LL
|L|L_LL_|
LL_LL_L_L
