9 10
0 0
8 9
LLL|L-|L-
L__--|-_|
L-|_-|_|L
|___LL|_L
LL_L_|-_|
|L_-|LL_|
L|||_L_L_
L|_|-||L|
|||_|_--_
LL_L_LLLL
