9 10
0 0
8 9
L-L||||_L
L|---|||_
|||L||LL_
|||--||_|
L___-L|__
|LLL|||--
LL-|||--L
L_L|_|--L
L|-|_LL__
L_LL__LL_
