9 10
0 0
8 9
L-L__L--_
|L--L||--
|-__||L_|
L--L|-L||
L---||LL-
L|__L-L_|
L-|LL||||
||L|L|L||
L_L_-|||_
L____L_L_
