9 10
0 0
8 9
LL|-_L_L_
L_L||L-|-
L-|LLL|L|
|_L_L-_||
|||L||_L-
||LL-_|--
L_||-__|_
|_|_L|||L
|L____|__
LLLL_LL_L
