9 5
0 0
8 4
LLL||--||
|_-|_L_L_
|LL|-||L_
L_|_-__|_
L__LLLLL_
