9 5
0 0
8 4
|_-|--_L_
LL-|_--L-
L|L-LL-_L
|_---|---
LLL__L_LL
