9 5
0 0
8 4
L|_L||_-L
|_-_|||||
|-||_|L_|
|L_-___LL
LL__L____
