9 5
0 0
8 4
L|L-|--_L
|_LL-LL|_
||--|L-L|
LL_|||___
LL__L__L_
