9 5
0 0
8 4
|_L-_-L|_
L___L___-
L_|-_L|-|
L_-_-|_--
LLL_LLL_L
