9 5
0 0
8 4
|_|-_||_|
L-_L|L--|
|_L_-L_|-
||-|_LL_|
L___LL_LL
