9 5
0 0
8 4
|L|L|-L-_
L||-||L||
L|-|_|_|L
|---LL|__
LLL_____L
