9 5
0 0
8 4
||||L_-_L
L-L_|____
|_LL_L_--
|LL-_||||
LLL____LL
