9 6
0 0
8 5
|-_-_-L-|
|____|||_
|_-|__LL|
||LLL-_-L
L|____--|
LL__LL___
