9 6
0 0
8 5
|LL__--||
L|LLL||L_
||L|_L_--
L|--L-L|-
|--__L|L-
L_L______
