9 6
0 0
8 5
|_L_L|_-L
LL_|||___
L_L-___--
||L-|L|L|
|L|__|-|L
LLL_L_L__
