9 6
0 0
8 5
L---L_|L_
|_||__|-|
|_-|L_||_
L-L|LLL_|
|||-_---_
LLL_L__L_
