9 6
0 0
8 5
LL||_|L-_
|||-L||||
|-L-L||L-
|_L_|||L_
L_|-L-__-
LLL__LLLL
