9 6
0 0
8 5
|||L_|-_|
|L-|--||-
|L_|---L|
LL-L-LL_L
|-LLLL-__
L____L_L_
