9 6
0 0
8 5
L|-||L--_
L|_||L|_-
LL|_-_|L_
|_|_L_-__
|_-_L-||L
LL___LL_L
