9 7
0 0
8 6
|_LL__||_
|-_|L__||
||L_|L--L
|LLLL-|__
|L||LL_-|
|_-__-||L
LL_L____L
