9 7
0 0
8 6
||L____LL
||_|_||_|
L-|--L||_
L-|L_-_-L
|_-LL-|||
|||----_L
LL___L_L_
