9 7
0 0
8 6
|_|L|L_LL
|L__|-L_-
L__|-|L|-
L_------|
|L-_||L_|
|||L-|_L-
LL_LL__LL
