9 7
0 0
8 6
|||__--_L
L__-_|-L_
|-|_|_L--
L||L--_-|
|__||-L|L
|_-----L|
L__LLL__L
