9 7
0 0
8 6
||____-L-
|LL|_|-|-
|_--|-L-_
L_|L-|___
|---|--L|
|-L|_-|-|
LLLLL_LL_
