9 7
0 0
8 6
|L__L|L-L
LLL-|_|_|
||L-___L|
||-|L-|__
||--_|L_|
L--LL_-|L
LL__LLL_L
