9 7
0 0
8 6
|L-||LLL|
L_L_|__L|
|||__-|_|
|_L|_|-__
L-_-|L_-|
L|-_||__|
LLLL__LLL
