9 8
0 0
8 7
|||-_|---
|L-_L-__|
L||_-LL-|
|-L--_|L|
|||--|_L|
LL-L-_-L_
|_|||--_L
LLL_L__L_
