9 8
0 0
8 7
L|L_|_|-|
L-||L_|L_
|_|_LL_L_
L|__|||L_
|L|L||_|L
||L__L||_
|__|_-|L|
LL____LLL
