9 8
0 0
8 7
|__L_L|-_
|_L-L|_-_
|L|___L-|
L|L-_|_||
L|||__L|L
L|-||L|__
|--L|-||-
LL__L__LL
