9 8
0 0
8 7
LLL|-|-_-
L|||_|---
L_-LL||LL
|||L-_|||
|-_|||__|
||--|-LLL
|L|LL-__-
LL______L
