9 9
0 0
8 8
L_L_-L|L|
L_-|-LL|-
LL--LL|-|
|||__-|--
LL_|---|L
||____L|L
LL||__--L
|_|_|--||
L___LLL_L
