9 9
0 0
8 8
L_---|-_|
L-|L|_--L
|-_|_---L
|L-_L-LL-
L|--L_--|
L_L|-L-|-
||L--__L-
L_--_L---
L___L__LL
