9 9
0 0
8 8
LL-|_L-__
|_L-_|-_L
L-L-_L_-L
|--__-_L_
L|--_-||-
L|LLL|__L
L_L--__|_
|---L_-L_
LLLL_L_L_
