9 9
0 0
8 8
|L|L-__L_
L-L_|__|L
|-__|_|L-
|----|LL-
L_L_|LL||
L|L|-||LL
|_-__L__L
|-L|-|-|-
LL__LLL_L
