9 9
0 0
8 8
|L|_--__|
L_LLL_|L-
L_|--|_L|
LL-|__L|_
|L---L__L
L_L-|--L|
|_|_L||__
L-||-LLL_
L__L__L_L
