9 9
0 0
8 8
L-L||__||
|L-|L-L-|
|--|L|_L-
|-__L-LL_
L_-|--_L_
|||_____-
|LL_-_||_
|_|-L|-_-
L_LLL_LLL
