9 9
0 0
8 8
|_||_|--L
|__LL|_L_
L_L|_L_|L
L||||-||-
|||_LL|L_
L_-L-L_-L
L|_L||L-_
|-|L|L_-_
L__L_____
