9 9
0 0
8 8
|LL|L|_||
L|L-__L|_
L-_--L-L-
|_L-_|LL-
|-L-|---L
|L_||-_--
|_-L___L|
L--_||_-|
L_LLL_L__
